s7|77---7 
777  --7 7
-- --7-7-7
- 7_-  -- 
77  7 7  7
 7---7  7-
   7-7  77
7 7-7-77--
7--7--77-g